############
#...###...##
.....##..###
##.#......##
##.###....##
##...###.#.#
####.###...#
####..####.#
#..##..##..#
######......
####...#####
############