############
............
#..#.##.##.#
##.#.#..#..#
#.....#.##.#
#.#.#.#.#..#
##.##.#.#.##
#.......#..#
#.#.#####.##
#.#.....#..#
#.#.#.#...##
############