############
...##.##...#
##........##
#..######.##
####.......#
#....#.###.#
###........#
#...######.#
#####...#..#
#...#.#.#.##
#.#...#.....
############