############
....#.#....#
#.#.#.#.#.##
#.#.#.#.#..#
#.#.....#.##
#.##.#.##..#
#..##.##..##
#.#.....#..#
#.#.#.#.####
###.#.#.#..#
#...#.#.....
############